0000000000000000000
0005005005005005000
0000000000000000000
0000400000000040000
0000000000000000000
0004004004004004000
0000000000000000000
0004000000000040000
0000000000000000000
0505030201020305050
0000000000000000000
0000400000000040000
0000000000000000000
0302010203020102030
0000000000000000000
0004000000000040000
0000000000000000000
0102030201020302010
