00000000000000000
00000000000000000
00400400400400400
00000000000000000
00000000000000000
00000000000000000
00300300300300300
00000000000000000
00000000000000000
00000000000000000
00200200200200200
00000000000000000
00000000000000000
00000000000000000
00100100100100100
