000000000000000000
000000000000000000
000400400400400400
000000000000000000
000000000000000000
000000000000000000
000300300300300300
000000000000000000
000000000000000000
000000000000000000
000200200200200200
000000000000000000
000000000000000000
000000000000000000
000100100100100100
