0000000000000000000000000000000000
0044444444444444444444444444444400
0033333333333333333333333333333300
0033333333333333333333333333333300
0022222222222222222222222222222200
0022222222222222222222222222222200
0011111111111111111111111111111100
0011111111111111111111111111111100
0000000000000000000000000000000000