0000000000000000000
0005004000004005000
0000000000000000000
0000000005000000000
0000000000000000000
0004003000003004000
0000000000000000000
0000000004000000000
0000000000000000000
0003002000002003000
0000000000000000000
0000000003000000000
0000000000000000000
0002001000001002000
0000000000000000000
0000000002000000000
0000000000000000000
0001005001005001000
