0000000000000
0033333333300
0420211120240
0420211120240
0333333333330
0002222222000
0011111111100
0222222222220
0400000000040
0400000000040
0033333333300
0003333333000